___TEET___
__TTEETTTT
_________T
TTTT__T__T
______T___
_____XT___
___T__T___
___T__T___
