___TTET___
__TTTETTTT
____T_T__T
TT____T__T
______T___
_E___E____
___T__T___
___T__T__X
