___TT_T___
__TTT_TTTT
____T_T__T
TT____T__T
______T___
_E________
___T__T___
___T__T__X
